NO ./assets/TECH_NO.xpm
SO ./assets/TECH_SO.xpm
WE ./assets/TECH_WE.xpm
EA ./assets/TECH_EA.xpm

F 255,255,255
C 0,0,0

        1111111111111111111111111
        1000000000110000000000001
        101100000111000W000000001
        1001000000000000000000001
111111111011000001110000000000001
100000000011000001110111111111111
11110111111111011100000010001
11110111111111011101010010001
11000000110101011100000010001
10000000000000001100000010001
10000000000000001101010010001
110000011101010111110111100111
11110111 1110101 101111010001
11111111 1111111 111111111111